1111111111111111111111111111111111
1E0000000000000C00M00C000000000001
10100101001000001M100100CMC0010101
1010010010101010001001000000010101
1P0000000C00C000000000M000000000C1
1111111111111111111111111111111111